********************                    ********************
*==================*                    *==================*
*==================*                    *==================*
*==================**********************==================*
*==========================================================*
*==========================================================*
*==========================================================*
*==================**********************==================*
*==================*                    *==================*
********************                    ********************
